.,.,.,.,.,.,.,.,.,.,.
.,.,.,e,.,.,e,.,g,.,.
.,.,.,.,e,e,.,.,g,.,.
.,.,.,.,.,.,.,s,w,.,.
.,.,.,.,.,.,w,w,w,.,.
.,.,e,.,.,e,.,w,w,.,.
.,.,e,.,.,w,.,s,w,.,.
.,.,e,e,w,w,.,s,w,.,.
.,e,.,w,w,.,s,.,g,.,.
.,.,.,.,.,.,.,.,.,.,.
